"filename", "language", "Java", "Markdown", "comment", "blank", "total"
"d:\Code\JavGameTest\README.md", "Markdown", 0, 1, 0, 0, 1
"d:\Code\JavGameTest\bin\inputs\KeyboardInputs.class", "Java", 16, 0, 0, 0, 16
"d:\Code\JavGameTest\bin\inputs\MouseInputs.class", "Java", 27, 0, 0, 0, 27
"d:\Code\JavGameTest\bin\main\Game.class", "Java", 13, 0, 0, 0, 13
"d:\Code\JavGameTest\bin\main\GamePanel.class", "Java", 19, 0, 0, 0, 19
"d:\Code\JavGameTest\bin\main\GameWindow.class", "Java", 20, 0, 0, 0, 20
"d:\Code\JavGameTest\bin\main\MainClass.class", "Java", 8, 0, 0, 0, 8
"d:\Code\JavGameTest\src\inputs\KeyboardInputs.java", "Java", 33, 0, 2, 14, 49
"d:\Code\JavGameTest\src\inputs\MouseInputs.java", "Java", 34, 0, 5, 20, 59
"d:\Code\JavGameTest\src\main\Game.java", "Java", 10, 0, 0, 7, 17
"d:\Code\JavGameTest\src\main\GamePanel.java", "Java", 32, 0, 0, 17, 49
"d:\Code\JavGameTest\src\main\GameWindow.java", "Java", 13, 0, 0, 8, 21
"d:\Code\JavGameTest\src\main\MainClass.java", "Java", 6, 0, 0, 4, 10
"Total", "-", 231, 1, 7, 70, 309