"filename", "language", "Java", "JSON", "Markdown", "comment", "blank", "total"
"d:\Code\JavGameTest\.VSCodeCounter\2024-01-05_13-27-47\details.md", "Markdown", 0, 0, 22, 0, 6, 28
"d:\Code\JavGameTest\.VSCodeCounter\2024-01-05_13-27-47\diff-details.md", "Markdown", 0, 0, 9, 0, 6, 15
"d:\Code\JavGameTest\.VSCodeCounter\2024-01-05_13-27-47\diff.md", "Markdown", 0, 0, 12, 0, 7, 19
"d:\Code\JavGameTest\.VSCodeCounter\2024-01-05_13-27-47\results.json", "JSON", 0, 1, 0, 0, 0, 1
"d:\Code\JavGameTest\.VSCodeCounter\2024-01-05_13-27-47\results.md", "Markdown", 0, 0, 22, 0, 7, 29
"d:\Code\JavGameTest\bin\entities\Entity.class", "Java", 18, 0, 0, 0, 0, 18
"d:\Code\JavGameTest\bin\entities\Player.class", "Java", 81, 0, 0, 0, 0, 81
"d:\Code\JavGameTest\bin\inputs\KeyboardInputs.class", "Java", 7, 0, 0, 0, 0, 7
"d:\Code\JavGameTest\bin\inputs\MouseInputs.class", "Java", -1, 0, 0, 0, 0, -1
"d:\Code\JavGameTest\bin\levels\Level.class", "Java", 13, 0, 0, 0, 0, 13
"d:\Code\JavGameTest\bin\levels\LevelManager.class", "Java", 22, 0, 0, 0, 0, 22
"d:\Code\JavGameTest\bin\main\Game.class", "Java", 41, 0, 0, 0, 0, 41
"d:\Code\JavGameTest\bin\main\GameWindow$1.class", "Java", 14, 0, 0, 0, 1, 15
"d:\Code\JavGameTest\bin\main\GameWindow.class", "Java", 6, 0, 0, 0, 0, 6
"d:\Code\JavGameTest\bin\utilz\Constants$Direction.class", "Java", 7, 0, 0, 0, 0, 7
"d:\Code\JavGameTest\bin\utilz\Constants$PlayerConstants.class", "Java", 12, 0, 0, 0, 0, 12
"d:\Code\JavGameTest\bin\utilz\Constants.class", "Java", 5, 0, 0, 0, 0, 5
"d:\Code\JavGameTest\bin\utilz\HelpMethods.class", "Java", 23, 0, 0, 0, 0, 23
"d:\Code\JavGameTest\bin\utilz\LoadSave.class", "Java", 18, 0, 0, 0, 0, 18
"d:\Code\JavGameTest\src\entities\Entity.java", "Java", 26, 0, 0, 4, 10, 40
"d:\Code\JavGameTest\src\entities\Player.java", "Java", 179, 0, 0, 7, 50, 236
"d:\Code\JavGameTest\src\inputs\KeyboardInputs.java", "Java", 21, 0, 0, -1, -1, 19
"d:\Code\JavGameTest\src\inputs\MouseInputs.java", "Java", 1, 0, 0, 1, -1, 1
"d:\Code\JavGameTest\src\levels\Level.java", "Java", 13, 0, 0, 0, 7, 20
"d:\Code\JavGameTest\src\levels\LevelManager.java", "Java", 62, 0, 0, 1, 13, 76
"d:\Code\JavGameTest\src\main\Game.java", "Java", 73, 0, 0, 5, 33, 111
"d:\Code\JavGameTest\src\main\GamePanel.java", "Java", 9, 0, 0, 1, 0, 10
"d:\Code\JavGameTest\src\main\GameWindow.java", "Java", 12, 0, 0, 0, 4, 16
"d:\Code\JavGameTest\src\utilz\Constants.java", "Java", 45, 0, 0, 0, 10, 55
"d:\Code\JavGameTest\src\utilz\HelpMethods.java", "Java", 50, 0, 0, 3, 16, 69
"d:\Code\JavGameTest\src\utilz\LoadSave.java", "Java", 35, 0, 0, 1, 10, 46
"Total", "-", 792, 1, 65, 22, 178, 1058