"filename", "language", "Java", "Markdown", "JSON", "comment", "blank", "total"
"d:\Code\JavGameTest\.VSCodeCounter\2024-01-05_13-27-47\details.md", "Markdown", 0, 22, 0, 0, 6, 28
"d:\Code\JavGameTest\.VSCodeCounter\2024-01-05_13-27-47\diff-details.md", "Markdown", 0, 9, 0, 0, 6, 15
"d:\Code\JavGameTest\.VSCodeCounter\2024-01-05_13-27-47\diff.md", "Markdown", 0, 12, 0, 0, 7, 19
"d:\Code\JavGameTest\.VSCodeCounter\2024-01-05_13-27-47\results.json", "JSON", 0, 0, 1, 0, 0, 1
"d:\Code\JavGameTest\.VSCodeCounter\2024-01-05_13-27-47\results.md", "Markdown", 0, 22, 0, 0, 7, 29
"d:\Code\JavGameTest\.VSCodeCounter\2024-01-06_16-50-44\details.md", "Markdown", 0, 44, 0, 0, 6, 50
"d:\Code\JavGameTest\.VSCodeCounter\2024-01-06_16-50-44\diff-details.md", "Markdown", 0, 40, 0, 0, 6, 46
"d:\Code\JavGameTest\.VSCodeCounter\2024-01-06_16-50-44\diff.md", "Markdown", 0, 30, 0, 0, 7, 37
"d:\Code\JavGameTest\.VSCodeCounter\2024-01-06_16-50-44\results.json", "JSON", 0, 0, 1, 0, 0, 1
"d:\Code\JavGameTest\.VSCodeCounter\2024-01-06_16-50-44\results.md", "Markdown", 0, 31, 0, 0, 7, 38
"d:\Code\JavGameTest\README.md", "Markdown", 0, 1, 0, 0, 0, 1
"d:\Code\JavGameTest\bin\entities\Entity.class", "Java", 18, 0, 0, 0, 0, 18
"d:\Code\JavGameTest\bin\entities\Player.class", "Java", 79, 0, 0, 0, 0, 79
"d:\Code\JavGameTest\bin\inputs\KeyboardInputs.class", "Java", 23, 0, 0, 0, 0, 23
"d:\Code\JavGameTest\bin\inputs\MouseInputs.class", "Java", 26, 0, 0, 0, 0, 26
"d:\Code\JavGameTest\bin\levels\Level.class", "Java", 13, 0, 0, 0, 0, 13
"d:\Code\JavGameTest\bin\levels\LevelManager.class", "Java", 20, 0, 0, 0, 0, 20
"d:\Code\JavGameTest\bin\main\Game.class", "Java", 54, 0, 0, 0, 0, 54
"d:\Code\JavGameTest\bin\main\GamePanel.class", "Java", 19, 0, 0, 0, 0, 19
"d:\Code\JavGameTest\bin\main\GameWindow$1.class", "Java", 14, 0, 0, 0, 1, 15
"d:\Code\JavGameTest\bin\main\GameWindow.class", "Java", 26, 0, 0, 0, 0, 26
"d:\Code\JavGameTest\bin\main\MainClass.class", "Java", 8, 0, 0, 0, 0, 8
"d:\Code\JavGameTest\bin\utilz\Constants$Direction.class", "Java", 7, 0, 0, 0, 0, 7
"d:\Code\JavGameTest\bin\utilz\Constants$PlayerConstants.class", "Java", 12, 0, 0, 0, 0, 12
"d:\Code\JavGameTest\bin\utilz\Constants.class", "Java", 5, 0, 0, 0, 0, 5
"d:\Code\JavGameTest\bin\utilz\HelpMethods.class", "Java", 22, 0, 0, 0, 0, 22
"d:\Code\JavGameTest\bin\utilz\LoadSave.class", "Java", 18, 0, 0, 0, 0, 18
"d:\Code\JavGameTest\src\entities\Entity.java", "Java", 26, 0, 0, 4, 10, 40
"d:\Code\JavGameTest\src\entities\Player.java", "Java", 178, 0, 0, 7, 50, 235
"d:\Code\JavGameTest\src\inputs\KeyboardInputs.java", "Java", 54, 0, 0, 1, 13, 68
"d:\Code\JavGameTest\src\inputs\MouseInputs.java", "Java", 35, 0, 0, 6, 19, 60
"d:\Code\JavGameTest\src\levels\Level.java", "Java", 13, 0, 0, 0, 7, 20
"d:\Code\JavGameTest\src\levels\LevelManager.java", "Java", 39, 0, 0, 1, 13, 53
"d:\Code\JavGameTest\src\main\Game.java", "Java", 83, 0, 0, 5, 40, 128
"d:\Code\JavGameTest\src\main\GamePanel.java", "Java", 41, 0, 0, 1, 17, 59
"d:\Code\JavGameTest\src\main\GameWindow.java", "Java", 25, 0, 0, 0, 12, 37
"d:\Code\JavGameTest\src\main\MainClass.java", "Java", 6, 0, 0, 0, 4, 10
"d:\Code\JavGameTest\src\utilz\Constants.java", "Java", 45, 0, 0, 0, 10, 55
"d:\Code\JavGameTest\src\utilz\HelpMethods.java", "Java", 50, 0, 0, 3, 16, 69
"d:\Code\JavGameTest\src\utilz\LoadSave.java", "Java", 35, 0, 0, 1, 10, 46
"Total", "-", 994, 211, 2, 29, 274, 1510